11111111111
10P00000001
100000C0001
10000000001
10C00000001
11E11111111
10000C00001
11111111111
