11111111
1P0000C1
100C000001
10000001
100C00E0
11111111
