10111111
1P0000C1
100C0001
10000001
100C00E1
11111111
