111111111
1PCE00001

111111111
