
1PCE00001
100000001
111111111
