11111111
1P000001
10000001
10000001
100000E1
11111111
