11111111
100000C1
100C0001
10000001
100C00E1
11111111
