11111111
1P0000C1
100C0001
10000001
100C0001
11111111
