11111111
1P0000C1
100C0001
10000011
100C01E1
11111111
