11111111
10P000C1
100C0001
1P000001
100C00E1
11111111
