11111111
1P0000C1
100C0001
10E00001
100C00E1
11111111
